NO ./path_file
SO ./path_file_2
WE ./path_file_3
EA ./path_file_4

F 255,255,255
C 5,25,25

1111111111111111111111111
1000000000110000000000001
1011000001110000002000001
1001003000000000000000301
1011000001110000000000001
10000000001100000111011111111
11110111111111011100000000001
11110111  100011101010010001
11000001  101011100000000001
10002000110000001100300010001
100000N0000000001101010010001
 100000111010101111101111030111
  1101111110101  101111010001
   111111111111  111111111111