NO ./path_file
SO ./path_file_2
WE ./path_file_3
EA ./path_file_4

F 255,255,255
C 5,25,25

  11111111111111111111
0010000000000000000001     
 100000000N0000000001
10111111111111100001
111          111011
1            11111