NO ./path_file
SO ./path_file_2
WE ./path_file_3
EA ./path_file_4

F 255,255,255
C 5,25,25

  11111111111111111111
001110000000000000000011     
 100000000N0000000001111    
101111111111111000001
111          0100011
1            111110
1            111111111111

