NO ./path_file
SO ./path_file_2
WE ./path_file_3
EA ./path_file_4

F 255,255,255
C 5,256,255

11111111111111111111
10000000000000000001
1000000000N000000001
11111111111111111111