NO ./path_file test
SO ./path_file_2
WE ./path_file_3
EA ./path_file_4

F 255,255,255
C 5,25,25

11111111111111111111
10000000000000000001
10000000N00000000001
11111111111111111111