NO ./img/img_n
SO ./img/img_n
WE ./img/img_n
EA ./img/img_n

F 255,255,255
C 5,25,25

  10111111111111111111     
10110000000000000000011111
110000000S0000000001111
101111111111111000001
111          0100011
1            111010
1            111111111111

