NO ./img/img_e
SO ./img/img_e
WE ./img/img_e
EA ./img/img_e

F 255,255,255
C 5,25,25

11111111111111111
10001000000011111  
10001000000001111
10001000000000111  
100000000N0000011
10000010000000001 
11100010000000101
10000010000100101
11111111111111111