NO ./img/NORTH.xpm
SO ./img/SOUTH.xpm
WE ./img/WEST.xpm
EA ./img/EAST.xpm

F 255,255,255
C 5,25,25

1111111111111
1110000111111  
1100000001111
1000000000111  
10000N0000011
1011100000001 
1010100000101
1000000100101
1111111111111